0,0_00860
1,1_00435
2,2_01262
3,3_00035
4,4_01435
5,5_00535
6,6_06707
7,7_00365
8,8_00039
9,9_02029
